11111111111111
1000P000CC0001
10001000100001
10001000N00001
10001000110001
1000100CC00001
100C001010C001
1C00000000E001
11111111111111
